P2
# dummy 10x10 test map (0=black(obstacle), 205=unknown, 254=free)
10 10
254
254 254 254 254 254 254 254 254 254 254
254 205 205 205 205 205 205 205 205 254
254 205 254 254 254 254 254 254 205 254
254 205 254 0   0   0   0   254 205 254
254 205 254 0   254 254 0   254 205 254
254 205 254 0   254 254 0   254 205 254
254 205 254 0   0   0   0   254 205 254
254 205 254 254 254 254 254 254 205 254
254 205 205 205 205 205 205 205 205 254
254 254 254 254 254 254 254 254 254 254
